88,107,91,115,3,8,true
83,121,85,114,2,-7,false
73,114,81,110,8,-4,false
87,117,104,136,17,19,true
86,113,90,125,4,12,true
85,108,71,100,14,8,true
82,111,75,103,7,8,true
94,129,101,121,7,-8,false
91,120,93,111,2,-9,false
65,79,68,99,3,20,true
79,107,78,97,1,10,true
80,107,73,98,7,9,true
96,127,82,106,14,21,true
74,105,96,120,22,15,true
82,108,89,115,7,7,true
92,113,103,133,11,20,true
66,87,97,133,31,46,true
84,105,77,108,7,-3,false
67,88,82,103,15,15,true
84,110,94,120,10,10,true
66,85,84,108,18,23,true
88,123,83,117,5,6,true
95,122,107,130,12,8,true
74,89,82,,8,NaN,false
67,82,70,99,3,17,true
72,92,82,113,10,21,true
73,91,100,124,27,33,true
88,125,100,134,12,9,true
82,114,78,101,4,13,true
88,116,89,106,1,-10,false
77,109,87,119,10,10,true
88,111,107,131,19,20,true
80,93,82,106,2,13,true
72,101,83,112,11,11,true
72,86,94,113,22,27,true
80,99,77,97,3,2,true
97,130,100,137,3,7,true
100,130,83,109,17,21,true
87,109,72,103,15,6,true
64,88,87,107,23,19,true
64,81,79,109,15,28,true
83,118,109,131,26,13,true
76,107,93,118,17,11,true
111,141,88,123,23,18,true
80,112,101,142,21,30,true
90,121,84,124,6,-3,false
83,114,85,122,2,8,true
84,114,77,105,7,9,true
84,115,64,83,20,32,true
98,121,80,109,18,12,true
79,114,96,121,17,7,true
85,117,83,126,2,-9,false
80,99,78,95,2,4,true
77,106,88,121,11,15,true
73,116,80,108,7,-8,false
72,99,90,112,18,13,true
72,99,82,105,10,6,true
89,107,72,97,17,10,true
68,88,90,118,22,30,true
88,111,101,125,13,14,true
63,87,64,88,1,1,true
95,136,81,104,14,32,true
72,104,79,107,7,3,true
78,108,75,102,3,6,true
82,104,73,103,9,1,true
65,98,69,101,4,3,true
97,115,102,144,5,29,true
75,111,100,140,25,29,true
58,82,82,103,24,21,true
79,104,95,122,16,18,true
73,94,78,105,5,11,true
92,118,81,12,11,106,true
73,92,73,97,0,5,true
66,87,83,103,17,16,true
82,112,66,100,16,12,true
80,108,101,140,21,32,true
75,104,72,84,3,20,true
89,125,97,128,8,3,true
78,111,56,80,22,31,true
94,123,75,90,19,33,true
87,116,86,107,1,9,true
110,130,86,106,24,24,true
87,109,91,113,4,4,true
78,103,94,135,16,32,true
116,139,92,132,24,7,true
79,102,104,144,25,42,true
77,96,78,110,1,14,true
66,85,55,87,11,-2,false
79,111,78,95,1,16,true
82,104,59,92,23,12,true
60,75,76,99,16,24,true
69,99,71,95,2,-4,false
72,96,75,101,3,5,true
77,101,77,106,0,5,true
86,116,77,109,9,7,true
79,99,83,113,4,14,true
62,94,85,106,23,12,true
76,103,102,132,26,29,true
99,124,76,115,23,9,true
78,109,68,100,10,9,true
84,107,61,83,23,24,true
86,120,88,119,2,-1,false
94,115,67,105,27,10,true
69,36,92,,23,NaN,false
93,111,73,99,20,12,true
81,123,69,98,12,25,true
80,120,87,116,7,-4,false
94,18,206,25,112,7,true
82,101,90,120,8,19,true
69,90,84,111,15,21,true
82,110,76,107,6,3,true
88,107,83,118,5,-11,false
69,101,93,124,24,23,true
67,89,69,96,2,7,true
93,127,99,115,6,-12,false
99,123,98,124,1,-1,false
63,91,78,102,15,11,true
85,121,81,111,4,10,true
81,105,106,134,25,29,true
71,105,64,96,7,9,true
74,105,84,101,10,-4,false
95,115,85,117,10,-2,false
95,111,69,105,26,6,true
70,96,91,113,21,17,true
99,125,88,110,11,15,true
85,102,63,89,22,13,true
83,109,89,129,6,20,true
91,123,96,128,5,5,true
52,78,74,98,22,20,true
85,113,102,127,17,14,true
72,98,84,103,12,5,true
75,103,92,113,17,10,true
75,111,92,105,17,-6,false
78,107,88,113,10,6,true
73,95,64,86,9,9,true
79,111,82,107,3,-4,false
94,113,79,108,15,5,true
86,119,88,118,2,-1,false
75,96,84,117,9,21,true
70,107,91,113,21,6,true
85,116,79,97,6,19,true
103,128,94,117,9,11,true
94,115,103,126,9,11,true
95,127,93,124,2,3,true
70,90,81,107,11,17,true
93,122,90,115,3,7,true
82,115,77,104,5,11,true
84,107,69,95,15,12,true
74,103,85,117,11,14,true
81,118,78,108,3,10,true
78,100,71,94,7,6,true
70,104,79,108,9,4,true
79,102,76,108,3,-6,false
94,118,62,88,32,30,true
92,123,71,106,21,17,true
107,131,99,122,8,9,true
62,90,93,105,31,15,true
68,93,73,97,5,4,true
83,114,84,122,1,8,true
71,98,92,117,21,19,true
78,95,85,108,7,13,true
91,117,67,94,24,23,true
87,111,63,85,24,26,true
90,120,100,133,10,13,true
81,111,101,130,20,19,true
75,99,84,114,9,15,true
86,115,67,91,19,24,true
67,101,80,103,13,2,true
85,108,89,116,4,8,true
90,119,88,107,2,12,true
77,104,83,113,6,9,true
72,99,97,118,25,19,true
73,97,82,106,9,9,true
66,98,69,102,3,4,true
72,110,82,98,10,-12,false
88,132,101,126,13,-6,false
76,103,66,90,10,13,true
69,96,79,105,10,9,true
82,94,67,98,15,-4,false
78,98,82,107,4,9,true
88,118,76,96,12,22,true
79,115,111,133,32,18,true
92,117,88,111,4,6,true
83,103,95,118,12,15,true
81,103,87,114,6,11,true
82,120,97,130,15,10,true
90,108,87,116,3,-8,false
81,108,87,114,6,6,true
66,85,88,126,22,41,true
72,92,80,106,8,14,true
91,128,90,124,1,4,true
81,104,67,92,14,12,true
72,97,58,90,14,7,true
92,122,72,91,20,31,true
101,132,93,114,8,18,true
62,93,86,119,24,26,true
90,113,90,115,0,2,true
67,102,79,110,12,8,true
60,98,68,12,8,-86,false
76,102,96,122,20,20,true
71,94,72,95,1,1,true
79,106,90,114,11,8,true
86,122,91,117,5,-5,false
71,99,79,110,8,11,true
77,94,84,104,7,10,true
85,114,96,115,11,1,true
73,98,78,112,5,14,true
69,102,67,93,2,9,true
70,109,99,119,29,10,true
90,111,100,123,10,12,true
73,112,76,115,3,3,true
95,121,81,109,14,12,true
95,120,83,112,12,8,true
84,104,88,108,4,4,true
71,97,77,109,6,12,true
74,99,63,90,11,9,true
72,102,62,89,10,13,true
103,126,88,115,15,11,true
70,107,90,123,20,16,true
80,100,97,119,17,19,true
82,105,67,90,15,15,true
88,112,66,95,22,17,true
95,125,97,127,2,2,true
79,95,98,126,19,31,true
65,92,78,101,13,9,true
80,103,78,108,2,-5,false
81,117,70,97,11,20,true
71,100,92,119,21,19,true
82,110,81,106,1,4,true
87,115,85,106,2,9,true
83,110,66,101,17,9,true
99,130,92,127,7,3,true
90,123,95,114,5,-9,false
85,114,91,109,6,-5,false
90,125,83,114,7,11,true
74,94,75,104,1,10,true
98,136,94,130,4,6,true
72,99,79,107,7,8,true
74,98,85,105,11,7,true
77,96,87,116,10,20,true
74,94,66,99,8,-5,false
84,108,90,116,6,8,true
83,103,79,108,4,-5,false
89,128,103,114,14,-14,false
76,99,76,104,0,5,true
70,99,76,104,6,5,true
98,123,79,100,19,23,true
78,110,88,116,10,6,true
91,111,72,91,19,20,true
77,104,87,107,10,3,true
75,94,72,99,3,-5,false
95,115,97,123,2,8,true
88,113,83,98,5,15,true
98,117,86,121,12,-4,false
81,106,74,93,7,13,true
107,137,75,108,32,29,true
94,114,72,92,22,22,true
80,114,119,141,39,27,true
102,130,91,114,11,16,true
82,113,96,136,14,23,true
80,103,71,84,9,19,true
66,89,75,106,9,17,true
76,104,75,96,1,8,true
75,102,86,99,11,-3,false
69,94,89,122,20,28,true
86,111,93,123,7,12,true
67,92,76,111,9,19,true
69,98,62,101,7,-3,false
87,106,89,120,2,14,true
80,98,95,110,15,12,true
81,109,83,108,2,-1,false
75,112,92,128,17,16,true
90,123,89,112,1,11,true
82,12,188,30,106,18,true
88,116,77,103,11,13,true
84,114,65,83,19,31,true
92,113,71,99,21,14,true
71,94,82,101,11,7,true
77,102,74,90,3,12,true
77,113,72,109,5,4,true
83,115,80,109,3,6,true
102,123,77,109,25,14,true
92,131,87,115,5,16,true
94,130,84,14,10,116,true
72,103,60,97,12,6,true
88,116,91,109,3,-7,false
73,104,79,101,6,-3,false
87,110,76,109,11,1,true
114,153,88,119,26,34,true
96,119,80,98,16,21,true
93,118,94,122,1,4,true
78,106,90,123,12,17,true
75,95,69,,6,NaN,false
88,115,82,112,6,3,true
86,119,79,107,7,12,true
87,114,96,129,9,15,true
90,122,91,132,1,10,true
70,99,67,97,3,2,true
70,92,86,118,16,26,true
76,96,80,104,4,8,true
79,104,82,108,3,4,true
82,113,82,105,0,-8,false
89,121,76,109,13,12,true
78,116,61,83,17,33,true
78,102,56,93,22,9,true
74,96,97,124,23,28,true
80,106,77,100,3,6,true
81,108,93,123,12,15,true
90,111,119,140,29,29,true
60,91,86,115,26,24,true
99,119,97,125,2,-6,false
67,97,66,94,1,3,true
96,118,73,104,23,14,true
72,105,85,117,13,12,true
99,131,86,113,13,18,true
88,113,84,107,4,6,true
86,103,77,105,9,-2,false
85,104,97,127,12,23,true
86,111,100,122,14,11,true
60,81,90,124,30,43,true
79,102,101,132,22,30,true
104,139,92,120,12,19,true
84,113,89,122,5,9,true
87,115,78,101,9,14,true
75,96,76,93,1,-3,false
69,95,105,137,36,42,true
79,102,71,99,8,3,true
71,100,87,118,16,18,true
70,106,72,102,2,-4,false
71,86,98,116,27,30,true
111,133,83,117,28,16,true
110,141,87,119,23,22,true
94,115,95,117,1,2,true
74,99,77,114,3,15,true
79,108,95,117,16,9,true
82,110,94,111,12,1,true
91,122,92,134,1,12,true
103,145,84,117,19,28,true
66,85,81,120,15,35,true
94,116,89,124,5,-8,false
94,123,84,108,10,15,true
78,115,100,130,22,15,true
84,112,91,128,7,16,true
78,95,76,118,2,-23,false
66,92,82,115,16,23,true
76,95,73,92,3,3,true
97,119,82,108,15,11,true
92,128,105,131,13,3,true
81,114,88,110,7,-4,false
88,113,84,102,4,11,true
72,105,98,130,26,25,true
71,97,94,123,23,26,true
91,118,103,127,12,9,true
88,106,91,116,3,10,true
74,91,96,117,22,26,true
82,101,97,128,15,27,true
96,117,82,112,14,5,true
86,104,82,113,4,-9,false
78,98,85,107,7,9,true
95,125,79,118,16,7,true
54,82,79,97,25,15,true
97,119,93,120,4,-1,false
73,102,105,125,32,23,true
81,118,88,112,7,-6,false
76,102,65,101,11,1,true
77,106,97,131,20,25,true
68,85,61,98,7,-13,false
86,101,83,112,3,-11,false
67,88,95,138,28,50,true
92,124,90,130,2,-6,false
81,120,87,13,6,-107,false
79,114,78,109,1,5,true
86,117,82,120,4,-3,false
102,129,98,120,4,9,true
90,127,98,124,8,-3,false
106,133,74,99,32,34,true
90,120,89,126,1,-6,false
89,119,83,115,6,4,true
89,113,75,100,14,13,true
72,107,83,120,11,13,true
76,110,78,12,2,-98,false
100,26,87,,13,NaN,false
105,142,93,115,12,27,true
68,90,84,102,16,12,true
83,116,84,118,1,2,true
91,118,93,109,2,-9,false
68,97,74,94,6,-3,false
69,90,94,120,25,30,true
91,108,77,106,14,2,true
76,94,101,127,25,33,true
85,113,87,116,2,3,true
85,110,72,98,13,12,true
100,129,91,11,9,118,true
85,109,87,104,2,-5,false
96,114,87,118,9,-4,false
63,90,69,98,6,8,true
100,124,85,121,15,3,true
92,112,92,123,0,11,true
80,120,92,108,12,-12,false
83,107,65,77,18,30,true
87,119,71,100,16,19,true
75,112,106,133,31,21,true
72,115,78,97,6,-18,false
84,109,103,122,19,13,true
62,96,73,104,11,8,true
82,121,97,127,15,6,true
81,105,89,112,8,7,true
89,119,81,108,8,11,true
78,104,88,112,10,8,true
97,130,92,117,5,13,true
69,95,79,111,10,16,true
93,113,90,115,3,-2,false
96,127,71,102,25,25,true
76,94,80,103,4,9,true
99,137,81,113,18,24,true
102,129,79,103,23,26,true
82,109,89,122,7,13,true
76,105,87,115,11,10,true
91,116,76,103,15,13,true
89,113,86,104,3,9,true
87,113,90,119,3,6,true
74,102,64,104,10,-2,false
91,104,107,124,16,20,true
92,120,79,108,13,12,true
73,92,84,105,11,13,true
84,116,88,126,4,10,true
83,107,88,110,5,3,true
71,102,98,129,27,27,true
81,106,79,103,2,3,true
89,126,75,109,14,17,true
87,123,94,11,7,-112,false
89,108,81,109,8,-1,false
64,90,82,104,18,14,true
84,102,77,99,7,3,true
88,115,78,109,10,6,true
72,107,80,104,8,-3,false
103,142,82,120,21,22,true
95,132,80,107,15,25,true
63,90,95,124,32,34,true
93,116,68,95,25,21,true
86,114,87,111,1,-3,false
88,113,89,125,1,12,true
65,87,69,90,4,3,true
69,90,92,120,23,30,true
84,114,91,108,7,-6,false
74,94,67,91,7,3,true
74,102,80,101,6,-1,false
95,11,215,27,120,16,true
86,109,77,100,9,9,true
72,95,83,101,11,6,true
84,111,112,132,28,21,true
84,115,87,11,3,-104,false
105,131,100,136,5,-5,false
94,122,78,107,16,15,true
102,129,70,100,32,29,true
108,135,81,115,27,20,true
68,82,73,99,5,17,true
97,117,99,123,2,6,true
83,106,80,110,3,-4,false
104,139,79,110,25,29,true
81,108,73,102,8,6,true
89,109,83,120,6,-11,false
85,109,83,115,2,-6,false
101,124,104,131,3,7,true
82,95,96,125,14,30,true
91,115,100,124,9,9,true
76,12,184,19,108,7,true
81,109,67,90,14,19,true
102,119,85,101,17,18,true
84,104,78,109,6,-5,false
80,114,103,144,23,30,true
71,86,74,93,3,7,true
67,95,119,134,52,39,true
82,113,94,118,12,5,true
99,112,88,107,11,5,true
85,111,77,100,8,11,true
85,100,75,107,10,-7,false
82,112,79,104,3,8,true
69,92,78,108,9,16,true
60,80,82,110,22,30,true
71,94,69,88,2,6,true
89,100,93,116,4,16,true
76,110,75,106,1,4,true
99,124,74,111,25,13,true
69,94,79,99,10,5,true
60,82,79,96,19,14,true
